##################################
#         #                      #
#         #  ################### #
#         #  #      #     #   #  #
#         #  #   #  #  #  # # #  #
#     s   #  #   #  #  #  # # #  #
#         #  #   #  #  #  # # #  #
# ########## #   #  #  #  # # #  #
#         #  #   #  #  #  # # #  #
########  # ##   #  #  #  # # #  #
#         #  #   #  #  #  # # #  #
#         #  #   #     #    #    #
#   #######  # ###################
#            #                  e#
##################################
