###########
#    s    #
#  ###### #
#    #    #
#   e#   e#
###########