#########################################################################
#               #                                                       #
#               #   ##################################################  #
#               #   #                             #        #        #   #
#               #   #                        #    #   #    #   #    #   #
#         s     #   #                        #    #   #    #   #    #   #
#               #   #                        #    #   #    #   #    #   #
# ################  #                        #    #   #    #   #    #   #
#               #   #                        #    #   #    #   #    #   #
##############  # ###                        #    #   #    #   #    #   #
#               #   #                        #    #   #    #   #    #   #
#               #   #                        #        #        #        #
#   #############   #     ###############################################
#                   #                                                  e#
#########################################################################
